{
  "levels": [
    {
      "id": 1,
      "boards": [
        [
          [1, 0, 3, 0, 0, 0, 0, 0, 3, 0],
          [0, 0, 3, 0, 3, 3, 3, 0, 3, 0],
          [0, 0, 0, 0, 0, 0, 3, 0, 0, 0],
          [3, 3, 0, 3, 3, 0, 3, 3, 3, 0],
          [0, 0, 0, 0, 3, 0, 0, 0, 0, 0],
          [0, 3, 3, 0, 3, 0, 3, 3, 3, 0],
          [0, 0, 0, 0, 0, 0, 0, 0, 3, 0],
          [0, 3, 3, 3, 3, 3, 3, 0, 3, 0],
          [0, 0, 0, 0, 0, 0, 0, 0, 3, 0],
          [0, 3, 3, 3, 3, 3, 0, 0, 0, 2]
        ],
        [
          [0, 0, 0, 3, 3, 3, 0, 0, 0, 1],
          [0, 3, 0, 0, 0, 0, 0, 3, 0, 0],
          [0, 3, 0, 3, 3, 3, 0, 3, 3, 0],
          [0, 0, 0, 0, 0, 0, 0, 0, 3, 0],
          [3, 3, 3, 3, 3, 0, 3, 0, 3, 0],
          [0, 0, 0, 0, 3, 0, 3, 0, 0, 0],
          [0, 3, 3, 0, 0, 0, 3, 3, 3, 0],
          [0, 3, 0, 0, 3, 0, 0, 0, 3, 0],
          [0, 3, 0, 3, 3, 3, 3, 0, 3, 0],
          [2, 0, 0, 0, 0, 0, 0, 0, 0, 0]
        ]
      ]
    },
    {
      "id": 2,
      "boards": [
        [
          [0, 0, 0, 0, 0, 0, 0, 0, 0, 0],
          [0, 1, 0, 0, 3, 0, 0, 0, 0, 0],
          [0, 3, 3, 0, 3, 0, 3, 3, 3, 0],
          [0, 0, 0, 0, 3, 0, 0, 0, 3, 0],
          [0, 3, 0, 3, 3, 0, 3, 0, 3, 0],
          [0, 3, 0, 0, 0, 0, 3, 0, 0, 0],
          [0, 0, 0, 3, 3, 0, 3, 3, 3, 0],
          [0, 3, 0, 0, 3, 0, 0, 0, 0, 0],
          [0, 3, 3, 0, 3, 3, 3, 3, 3, 2],
          [0, 0, 0, 0, 0, 0, 0, 0, 0, 0]
        ],
        [
          [1, 0, 3, 0, 0, 0, 0, 3, 0, 0],
          [0, 0, 3, 0, 3, 3, 0, 3, 0, 3],
          [0, 0, 0, 0, 0, 0, 0, 0, 0, 0],
          [0, 3, 3, 3, 3, 3, 3, 3, 3, 0],
          [0, 0, 0, 0, 0, 0, 0, 0, 3, 0],
          [3, 3, 3, 3, 3, 0, 3, 0, 3, 0],
          [0, 0, 0, 0, 0, 0, 3, 0, 0, 0],
          [0, 3, 3, 3, 3, 0, 3, 3, 3, 0],
          [0, 0, 0, 0, 0, 0, 0, 0, 3, 0],
          [0, 3, 0, 3, 0, 3, 0, 0, 0, 2]
        ]
      ]
    },
    {
      "id": 3,
      "boards": [
        [
          [1, 0, 0, 0, 3, 0, 0, 0, 0, 0],
          [3, 3, 3, 0, 3, 0, 3, 3, 3, 0],
          [0, 0, 0, 0, 3, 0, 0, 0, 3, 0],
          [0, 3, 0, 3, 3, 3, 0, 3, 3, 0],
          [0, 3, 0, 0, 0, 0, 0, 3, 0, 0],
          [0, 3, 3, 3, 3, 3, 0, 3, 0, 3],
          [0, 0, 0, 0, 0, 0, 0, 3, 0, 0],
          [3, 3, 3, 3, 3, 3, 0, 3, 3, 0],
          [0, 0, 0, 0, 0, 0, 0, 0, 0, 0],
          [0, 3, 3, 3, 3, 3, 3, 3, 3, 2]
        ],
        [
          [0, 0, 0, 0, 0, 0, 0, 0, 1, 0],
          [0, 3, 3, 3, 3, 3, 3, 0, 3, 0],
          [0, 0, 0, 0, 0, 0, 3, 0, 0, 0],
          [0, 3, 3, 3, 3, 0, 3, 3, 3, 0],
          [0, 3, 0, 0, 0, 0, 0, 0, 3, 0],
          [0, 3, 0, 3, 3, 3, 3, 0, 3, 0],
          [0, 0, 0, 0, 0, 0, 0, 0, 3, 0],
          [3, 3, 3, 3, 3, 3, 3, 0, 3, 0],
          [0, 0, 0, 0, 0, 0, 0, 0, 0, 0],
          [2, 3, 3, 3, 3, 3, 3, 3, 3, 0]
        ]
      ]
    },
    {
      "id": 4,
      "boards": [
        [
          [0, 0, 0, 0, 0, 3, 0, 0, 0, 2],
          [0, 3, 3, 3, 0, 3, 0, 3, 3, 3],
          [0, 3, 0, 0, 0, 3, 0, 0, 0, 0],
          [0, 3, 0, 3, 3, 3, 3, 3, 3, 0],
          [0, 0, 0, 3, 0, 0, 0, 0, 3, 0],
          [3, 3, 0, 3, 0, 3, 3, 0, 3, 0],
          [0, 0, 0, 0, 0, 0, 0, 0, 3, 0],
          [0, 3, 3, 3, 3, 3, 3, 0, 3, 0],
          [1, 0, 0, 0, 0, 0, 0, 0, 0, 0],
          [3, 3, 3, 3, 3, 3, 3, 3, 3, 0]
        ],
        [
          [0, 0, 0, 0, 0, 0, 0, 0, 0, 0],
          [0, 3, 3, 3, 3, 3, 3, 3, 3, 0],
          [0, 3, 0, 0, 0, 0, 0, 0, 3, 0],
          [0, 3, 0, 3, 3, 3, 3, 0, 3, 0],
          [0, 0, 0, 3, 0, 0, 0, 0, 3, 2],
          [3, 3, 0, 3, 0, 3, 3, 0, 3, 0],
          [0, 0, 0, 3, 0, 0, 0, 0, 3, 0],
          [0, 3, 3, 3, 3, 3, 3, 3, 3, 0],
          [0, 0, 0, 0, 0, 0, 0, 0, 0, 0],
          [1, 3, 3, 3, 3, 3, 3, 3, 3, 0]
        ]
      ]
    },
    {
      "id": 5,
      "boards": [
        [
          [3, 3, 3, 3, 3, 3, 3, 3, 3, 2],
          [1, 0, 0, 0, 0, 0, 0, 0, 0, 0],
          [0, 3, 3, 3, 3, 3, 3, 3, 3, 0],
          [0, 3, 0, 0, 0, 0, 0, 0, 3, 0],
          [0, 3, 0, 3, 3, 3, 3, 0, 3, 0],
          [0, 3, 0, 0, 0, 0, 3, 0, 3, 0],
          [0, 3, 3, 3, 3, 0, 3, 0, 3, 0],
          [0, 0, 0, 0, 3, 0, 0, 0, 3, 0],
          [3, 3, 3, 0, 3, 3, 3, 0, 3, 0],
          [0, 0, 0, 0, 0, 0, 0, 0, 0, 0]
        ],
        [
          [0, 0, 0, 0, 0, 0, 0, 0, 0, 2],
          [0, 3, 3, 3, 3, 3, 3, 3, 0, 0],
          [0, 3, 0, 0, 0, 0, 0, 3, 0, 3],
          [0, 3, 0, 3, 3, 3, 0, 3, 0, 3],
          [0, 3, 0, 3, 0, 0, 0, 3, 0, 0],
          [0, 3, 0, 3, 0, 3, 3, 3, 3, 0],
          [0, 0, 0, 3, 0, 0, 0, 0, 0, 0],
          [3, 3, 0, 3, 3, 3, 3, 3, 3, 0],
          [1, 0, 0, 0, 0, 0, 0, 0, 0, 0],
          [3, 3, 3, 3, 3, 3, 3, 3, 3, 0]
        ]
      ]
    },
    {
      "id": 6,
      "boards": [
        [
          [3, 3, 3, 3, 3, 3, 3, 3, 3, 3],
          [3, 0, 0, 0, 0, 0, 0, 0, 0, 3],
          [3, 0, 3, 3, 3, 3, 3, 3, 0, 3],
          [3, 0, 3, 0, 1, 0, 3, 3, 0, 3],
          [3, 0, 3, 0, 3, 3, 0, 3, 0, 3],
          [3, 0, 3, 3, 0, 0, 3, 3, 0, 3],
          [3, 0, 3, 3, 0, 3, 3, 3, 0, 3],
          [3, 0, 3, 3, 3, 0, 3, 3, 0, 3],
          [3, 0, 0, 0, 0, 0, 0, 0, 0, 3],
          [3, 3, 3, 3, 3, 3, 3, 3, 2, 3]
        ],
        [
          [3, 3, 3, 3, 3, 3, 3, 3, 3, 3],
          [3, 0, 0, 0, 0, 0, 0, 0, 0, 3],
          [3, 0, 3, 3, 3, 3, 3, 3, 0, 3],
          [3, 0, 3, 3, 0, 0, 3, 3, 0, 3],
          [3, 0, 3, 0, 3, 0, 0, 3, 0, 3],
          [3, 0, 3, 0, 0, 3, 3, 3, 0, 3],
          [3, 0, 3, 3, 3, 0, 3, 3, 0, 3],
          [3, 0, 3, 3, 0, 3, 0, 3, 0, 3],
          [3, 0, 0, 0, 0, 0, 0, 0, 1, 3],
          [3, 3, 3, 3, 3, 3, 3, 2, 3, 3]
        ]
      ]
    }
  ]
}
